Auf der Suche
An Interactive Fiction by Franziska Geilen Kirchner
Release 1 / Serial number 170613 / Inform 7 build 6M62 (I6/v6.33 lib 6/12N) SD

Flat Rock_Sitis
 You land on a big flat grey stone. You think, the landing was quite easy but as you leave your spaceship, you realise that two of your three water container broke down. Without minimal one new watertank you can not continue your journey .

>west
You arrive at a stone cave. As you try to enter, small stones fall off the ceiling. Hurry up, you need to go back fast!

>east
You can't go that way.

>north
You follow the mountain's way into a canyon. All you can see is a big field of cactuses. You can't pass them.

>south
Here seems to be the end of Sitis. You can't go this way any longer.

>east
You can't go that way.

* * *

Auf der Suche
An Interactive Fiction by Franziska Geilen Kirchner
Release 1 / Serial number 170613 / Inform 7 build 6M62 (I6/v6.33 lib 6/12N) SD

Flat Rock_Sitis
 You land on a big flat grey stone. You think, the landing was quite easy but as you leave your spaceship, you realise that two of your three water container broke down. Without minimal one new watertank you can not continue your journey .

>north
You follow the mountain's way into a canyon. All you can see is a big field of cactuses. You can't pass them.

* * *

>south
Here seems to be the end of Sitis. You can't go this way any longer.

>west
You arrive at a stone cave. As you try to enter, small stones fall off the ceiling. Hurry up, you need to go back fast!

>east
You really don't want to be here. If your mission goes wrong you will end up here for sure.

* * *

Auf der Suche
An Interactive Fiction by Franziska Geilen Kirchner
Release 1 / Serial number 170613 / Inform 7 build 6M62 (I6/v6.33 lib 6/12N) SD

Flat Rock_Sitis
 You land on a big flat grey stone. You think, the landing was quite easy but as you leave your spaceship, you realise that two of your three water container broke down. Without minimal one new watertank you can not continue your journey .

>east
The Wide Desert
 The Desert of Sitis gives you the chance to gain orientation. When you look north you see a big brown golden palace. In the east you recognize an old dark House. Description missed! When you look south you recognize a lot of small white houses. It seems like people are living there .

>south
The Rampart of Sicuum

>east
The Rock Mine

>west
You arrive at a stone cave. As you try to enter, small stones fall off the ceiling. Hurry up, you need to go back fast!

* * *

>south
The Rampart of Sicuum

>south
The Agora of Sicuum

>west
The Domum Praesidium of Sicuum
You can see Mitéra here.

>east
The Agora of Sicuum

>east
The Home
You can see Anaidis and Carissimi here.

* * *

>east
The Wide Desert
 The Desert of Sitis gives you the chance to gain orientation. When you look north you see a big brown golden palace. In the east you recognize an old dark House. Description missed! When you look south you recognize a lot of small white houses. It seems like people are living there .

>north
The Protection Bridge

>south
The Agora of Sicuum

>west
The Domum Praesidium of Sicuum

>east
The Agora of Sicuum

>east
The House of Anaidis.

>north
The Rock Mine

* * *

>north
The Protection Bridge

>north
Palace of Holy Scorpius_Sitis

>south
The Protection Bridge

>east
The Jail

>west
The Protection Bridge

>south
The Wide Desert
 The Desert of Sitis gives you the chance to gain orientation. When you look north you see a big brown golden palace. In the east you recognize an old dark House. Description missed! When you look south you recognize a lot of small white houses. It seems like people are living there .

>south
The Rampart of Sicuum

>east
You can't go that way.

>south
The Agora of Sicuum

>east
The House of Anaidis

>west
The Agora of Sicuum

>west
The Domum Praesidium of Sicuum

* * *

>east
The Agora of Sicuum

>north
The Rampart of Sicuum

>south
The Agora of Sicuum

* * *

>east
The House of Anaidis

>north
Secret Passage_Sitis

>north
You can't go that way.

* * *

>east
The Wide Desert
 The Desert of Sitis gives you the chance to gain orientation. When you look north you see a big brown golden palace. In the east you recognize an old dark House. Description missed! When you look south you recognize a lot of small white houses. It seems like people are living there .

>east
The Jail

>north
You can't go that way.

>west
The Wide Desert
 The Desert of Sitis gives you the chance to gain orientation. When you look north you see a big brown golden palace. In the east you recognize an old dark House. Description missed! When you look south you recognize a lot of small white houses. It seems like people are living there .

>south
The Agora of Sicuum

* * *

>west
The Domum Praesidium of Sicuum

>south
You can't go that way.

>north
You can't go that way.

>east
The Agora of Sicuum

>east
The House of Anaidis

>east
The Rock Mine

>west
The House of Anaidis

>west
The Agora of Sicuum

>north
The Wide Desert
 The Desert of Sitis gives you the chance to gain orientation. When you look north you see a big brown golden palace. In the east you recognize an old dark House. Description missed! When you look south you recognize a lot of small white houses. It seems like people are living there .

>east
The Jail

* * *

Auf der Suche
An Interactive Fiction by Franziska Geilen Kirchner
Release 1 / Serial number 170613 / Inform 7 build 6M62 (I6/v6.33 lib 6/12N) SD

Flat Rock_Sitis
 You land on a big flat grey stone. You think, the landing was quite easy but as you leave your spaceship, you realise that two of your three water container broke down. Without minimal one new watertank you can not continue your journey .

>e
The Wide Desert
 The Desert of Sitis gives you the chance to gain orientation. When you look north you see a big brown golden palace. In the east you recognize an old dark House. Description missed! When you look south you recognize a lot of small white houses. It seems like people are living there .

>n
The Protection Bridge

>e
The Jail