Your ship falls through thick layers of dark clouds. Red flashes illuminate your surroundings. The lights on your console warn you of the dangerously fast approaching energy level zero. As you finally break through the last cloud, you get a glimpse of what awaits you underneath. 
Black planes and sharp cliffs of a dark red shape the landscape. In the east you perceive a massive rock formation, in the west you see a thick blue stream cutting through the plane , illuminating big portions of it in the process. Somewhere to the south there seem to be some sort of industrial constructions, far in the north you believe to recognize cubic shapes that reveal a city. You don't have time to study the landscape much longer. All you concentration is desperately needed as you find a gap in the ghastly cliffs and bring down your ship. Heavy jolting, followed by a sudden blow signalize your landing. 
Your ship's on the ground, and you are too, barely. Welcome to Frizza.

Frizza
An Interactive Fiction by Tim
Release 1 / Serial number 170615 / Inform 7 build 6M62 (I6/v6.33 lib 6/12N) SD

Landing Zone
You step out of your ship onto a small square in the middle of nowhere. Your ship's dead and with it the computer. It seems like you ought to explore the environment. You remeber having seen civilization-like shapes to the south and to the north.

>e
Ascent
The mountains are composed of stone in various shades of red and reach far to the sky. In between the cliffs and sheers you see a narrow path winding up. There is no clue on where it might lead, but you could find out.

>u
You have the feeling of being watched. You wouldn't want to climb the cliffs if someone is around.

>x
(Someone)
A lean but athletic figure, wrapped by several layers of what looks like tough leather. In a small gap of her hood you can see glinting eyes that reveal a sharp mind.

>call
That's not a verb I recognise.

>talk
That's not a verb I recognise.

>ask Dunia about herself
You are painfully near to trespass holy ground, stranger. I would advise against it. Who are you, anyway? You don't look like a Techie.

>answer Duju
(to Someone)
- Well then, that's not a bad way to start. Thinking about it - an outsider might be what we need. I'll introduce you to someone, and that is not an invitation.

 With seemingly little effort she climbs down the cliffs to your level, before insistently inviting you to come with her.
 Both of you walk through the scraggy landscape, her leading the way with distinct commands. Slowly you approach an archlike structure, close to one branch of the Flux. As you get nearer you perceive a couple of bulky shapes, guarding the entrance to the structure. Some hundred metes in front of the entrance your companion turns to you. 

- Try not to look too provoking.

You know why while passing the guards: each and every one of them gazes at you. In consideration of the thick armour plates, the rather oversized guns and their radiating blue glow you refrain from making any quick motions.

Flux Gate
You can see a console, a weapon's rack (on which is a gun) and two Duju here.

Inside you find yourself in the midst of a small-sized hall, that doesn't appear to justify any of the expenditure you just encountered. In the back you spot an opening and a staircase, leading downwards. To the left there is a full board of controls and two figures unhastily operating them. You can't look around any more, as you are approached quickly by an impressive sized person, already bellowing a few direct words with a booming voice.

 - Dunia! Who is this? Explain yourself!

- A guest of sorts. He stumbled about the Ascent when I found him. I don't think he's a Techie, at least he has a slightly better manners and he keeps his voice down to a sensible level when talking. Besides, I thought about his use in regard to certain issues, due to his undujulike appearance.

Both eyeball you thoroughly for what seems to you like hours. Eventually, the massive Duju makes a quick motion towards Dunia, indicating her to follow him. He shoots a last glance at you.

- Don't let yourself be found sniffing around somewhere, it would not contribute to your wellbeing.

 They march off, disappearing into the opening at the end of the hall. You are not guarded, it seems like you could look around. Of course you could also do as you were told and wait.

>answer Techie
Whom do you want to answer that to?

* * *

>x
What do you want to examine?

>x Du'un
A massive build draped with heavy robes. In his left hand he carries an oblong staff, with a glowing ord at the end, that appears to be somewhere between shamanic fetish and technical apparatus. The blue eyes are attentive, especially about you.

>x Flux Gate
You can't see any such thing.

>e
Wasteland
A pitiful piece of land. Black sand, red rocks and some sickish looking plants. If you are not looking for something particular there is no need to linger.

>w
Flux Gate
A gate of some sort, guarded.

You can see Du'un and Dunia here.

>x
What do you want to examine?

* * *

>e
Wasteland
A pitiful piece of land. Black sand, red rocks and some sickish looking plants. If you are not looking for something particular there is no need to linger.

>w
Flux Gate
A gate of some sort, guarded.

You can see Keeper Du'un and Dunia here.

>x
What do you want to examine?

>x Duun
You can't see any such thing.

>x Du'un
A massive build draped with heavy robes. In his left hand he carries an oblong staff, with a glowing ord at the end, that appears to be somewhere between shamanic fetish and technical apparatus. The blue eyes are attentive, especially about you.

>x Dunia
A lean but athletic figure, wrapped by several layers of what looks like tough leather. In a small gap of her hood you can see glinting eyes that reveal a sharp mind.

* * *

>look around
You can't see any such thing.

>look
Flux Gate
You can see a console, a weapon's rack (on which is a gun) and two Duju here.

>x
What do you want to examine?

>x Gate
You can't see any such thing.

>x Upper gate
You can't see any such thing.

>x Upper Gate_Frizza
You can't see any such thing.

>wait
You stand still where you were left. Time passes. However, that seems to be the only thing to change.

>wait
You pass the time looking closer at your surroundings, but you can't interpret all too much from the metallic alien structures. The architecture somewhat reminds you of the spiritual buildings on your home planet, as for the arching walls and the high ceiling. The only thing you hear is the distant, lamish flow of the Flux and the dull sounds of the two operators at the console.

>wait
Finally you see the two Duju returning from the opening. As they approach the big one actually looks amazed by your decent behaviour.

- It seems like you did as you were told. Maybe you don't have no ill intent after all. Indeed - that is exactly what we're going to find out, if you're willing. But you see, we don't want to force anything on you, you are free to leave. But if you are interested in helping us, we would be glad.

* * *

>x Upper Gate_Frizza
You can't see any such thing.

>x
What do you want to examine?

>x console
You see nothing special about the console.

>x
What do you want to examine?